TILEMAP
16 16 							-- Size of tile map in tiles
16 16							-- Tile size & block size
images/MapaB.png 	-- Tilesheet
8 6 								-- Number of tiles in tilesheet
1111111111111111
123456789ABCDEF1
1GHIJKLMNOPQRST1
1UVWXYZ        1
1              1
1              1
1              1
1       Q      1
1              1
1              1
1              1
1              1
12             1
1              1
1              1
1111111111111111